11111111111
10000EC1111
1001P111101
10000000001
11111111111