11111111111
10000EC1111
1001P111101
1000 000001
11111111111