1111111111111111111
10000 0000000000001
100000000E000000001
1000000000000000001
100000P000000000001
10000000 0000C00001
1000000000000000001
100 000000000000001
1000000090000000011
1000000000000000001
1000000000000000001
1111111111111111111