1111111111111111111111111111111111
1111111111111111111111111111111011
11111111111111E1111111111111111111
111111111111E111111111111111111111
1000000001000000000001000000000001
1111111111111111111111111111111111