111111111111111111
100000000000000001
100P00001111000001
100000111111000001
101111000000000011
100011000111000011
110000000000011111
100010001110001101
100011100000000001
100000100111110001
100001001111011111
100001111011100001
101100000000001111
100000111011001111
111111111111111111