111111111111111111111111111111111111
100000000000000000000000000000000001
100000001111000000000000001111000001
100000111111000000000001111110000001
101111000000000010001111000000000011
100011000111000010000011000111000011
100000000000011110010000000000011111
100010001110001100000010001110001101
100011100000000000000011100000000001
100000100111110000000000100111110001
100001001111011100000001001111011111
100001111011100001100001111011100001
101100000000001100000110000000000111
100000111011001000100000111011001111
100000C000000C00000000000000000C0001
1000000000000000C0000000000000000001
10000000000000000000E0P0000000000001
100000001111000000000000001111000001
100000111111000000000001111110000001
101111000000000010001111000000000011
100011000111000010000011000111000011
110000000000011110010000000000011111
100010001110001100000010001110001101
100011100000000000000011100000000001
100000100111110000000000100111110001
100001001111011100000001001111011111
100001111011100001100001111011100001
101100000000001100000110000000000111
100000111011001000100000111011001111
111111111111111111111111111111111111