111111111111111111111111111111111111
100000100000000000000000000000000001
100000001111000000000000001111000001
100000111111000000000011111100000001
101111000000000010001111000000000011
100011000111000010000011000111000011
10000000C000011110010000000000011111
100010001110001100000010001110001101
100011100000000000000011100000000001
100000100111110000000000100111110001
100001001111011100000001001111011111
100001111011100001100001111011100001
101100000000001100000110000000000111
100000111011001000100000111011001111
10000000C000000000000000000E00000001
10000000000000C00P000000000000000001
10000000000000000000C000000000000001
100000001111000000000000001111000001
100000111111000000000001111110000001
101111000000000010001111000000000011
100011000111000010000011000111000011
110000000000011110010000000000011111
100010001110001100000010001110001101
10001110000000000C000011100000000001
100000100111110000000000100111110001
100001001111011100000001001111011111
100001111011100001100001111011100001
101100000000001100000110000000000111
100000111011001000100000111011001111
111111111111111111111111111111111111